[
  [1,1,1,1,1,1,1],
  [1,1,0,0,0,1,1],
  [1,1,2,1,3,1,1],
  [1,0,0,0,0,1,1],
  [1,0,2,1,3,0,1],
  [1,1,0,5,0,0,1],
  [1,1,1,1,0,0,1],
  [1,1,1,1,1,1,1]
]